+-+-+-+-+-+-+
|           |
+ + + + + + +
|           |
+ + + + + + +
|           |
+ + + + + + +
|           |
+ + + + + + +
|           |
+ + + + + + +
|           |
+-+-+-+-+-+-+