+-+-+-+-+-+-+
|S|         |
+ +-+-+ + + +
|     |     |
+ +-+ + + + +
|     |     |
+-+ +-+-+ + +
| |     |   |
+ +-+ +-+ + +
|   | |     |
+-+ + +-+-+-+
|
+-+-+-+-+-+-+