+-+-+-+-+-+-+
|S      |   |
+ +-+-+ +-+ +
|     | |   |
+ +-+ + +-+-+
|     |   | |
+-+ +-+ + + +
| |     | | |
+ +-+ +-+ +-+
|   | |   | |
+-+ + + +-+-+
| + |
+-+-+-+-+-+-+