+-+-+-+-+-+-+
|S|         |
+ +-+-+ + + +
|     |     |
+ +-+ + + + +
|     |     |
+-+ +-+-+ + +
| |   | |   |
+ +-+ +-+ + +
|   | |     |
+-+ + +-+-+-+
|   |  
+-+-+-+-+-+-+